000000010
001000010
001000010
001000000
000001000
000000000